--#----#---#----
----------#---#-
---#---#----#---
--------#-------
----#------##---
----------#--#--
---#--##-----#-#
---#-##---------
-----#----------
#--#--------#-#-
##----#-----#---
-----------#----
------------#---
-----#----------
#----------##---
---#--#--------#
