#-----------#--#
---#--------#---
-----------##-#-
-#-#---##----#--
-#-------#------
---#---##-----#-
----------##----
--------#-#-----
--------------#-
---------#-----#
--#---#-----#--#
----------------
----------------
-----#---#-#----
----##----------
--#---##-#--#---
