#---#-----------
-##----#--------
-------#-#---#--
-#---#----------
##-#-#-----#----
#---#----#------
---------#------
#---------#--#--
--#---##----#---
----------------
------#---------
------------#---
------#---##---#
#-##------#-#---
#---#-----------
-----------#----
