---------
---------
-----#-##
---#-----
-----##--
------#-#
------#--
---------
--------#
