----##---
---#-----
---#--#--
---------
---------
-#-----#-
-#-------
-#-------
-------#-
