--#--#---
----#----
---------
-----#-#-
--------#
-#-------
-----#---
---------
#--#-----
