#----------------#----#-------
---------------------------##-
------------##-#-----##--#----
---#---#-#--------##-------#-#
-##-----#----#-----------#---#
-##-------#---#------#--------
------------------###-----#---
------#----------#-#-#--------
#-----------#--##------#--#-#-
---#---###--#---#------#------
--#---------#-----#--##----#--
-##----#-----#--#-#-----#-----
#------#--------#---#---------
#-#-----#--#-----####--#----##
#---#-#----------#--##------#-
-#----##----#-----#--#--------
