----------##----#------------#
-#-###-#-#-------#-#----#-#---
-----#----------#---------#---
--#-----##--------#------#----
-----#-#--#-------#-#---#-#--#
#----#-#---------#------##-#--
---#--#----#-#--#-----##--#---
-------------#---#-------#----
#----#------#-#------#---#----
------#--#--------##---#--#---
----#-----#-----#-----------#-
--#------##-----#---#---##-#--
-----##---#--------#--------#-
------#----#-##----#---#------
#---#-----#-----#------##-##--
---##--##----#---#------#-#---
