----------------#----------#--
----#--#---###------------#-#-
---##------------------#-#--#-
-----###---#---------#-#------
----#-----#-#----#------###---
--###-#--------##-------------
---#-#---#--------------#-#---
---##--------#--#-#---#---##-#
#---#-#---###----------#-#-#--
------#------##--#----#-------
##-#----#-----#-----#-#---#---
---------#----#-#-----#--#-#--
--#----#-------#-#-----#------
--#--##--#-----------#-#------
------#-----#-----#-#-#-------
----#-###----------------####-
